__,__,__,__,__,__,__,__,__,__
__,SH,DE,__,SE,DE,DE,__,__,__
__,__,DE,DE,SP,DE,__,__,__,__
__,__,DE,DE,__,DE,__,__,__,__
__,__,__,__,SE,DE,TR,__,__,__
__,__,__,__,BO,DE,__,__,__,__
