__,__,__,DE,DE,DE,DE,DE,DE,__
__,__,__,__,DE,DE,__,DE,DE,DE
__,__,__,__,SP,__,TR,SE,DE,DE
__,__,__,__,__,SH,DE,DE,DE,DE
__,__,__,__,__,__,__,BO,__,__
__,__,__,__,__,__,__,__,__,__
