__,__,__,SH,DE,DE,DE,DE,__,__
__,__,__,SE,DE,DE,SE,DE,DE,DE
__,SH,__,DE,SP,DE,DE,__,BO,__
__,DE,DE,DE,__,__,__,__,__,__
__,__,TR,__,__,__,__,__,__,__
__,__,__,__,__,__,__,__,__,__
