__,__,__,DE,DE,DE,DE,DE,TR,__
__,__,SH,DE,SE,DE,__,DE,__,__
__,__,__,DE,SP,__,__,DE,DE,__
__,__,__,__,__,__,__,__,DE,__
__,__,__,__,__,__,__,__,DE,BO
__,__,__,__,__,__,__,__,__,__
