__,__,__,__,__,DE,TR,__,__,__
__,__,__,__,DE,DE,__,__,__,__
__,__,__,__,SP,SE,SH,__,__,__
__,__,__,__,DE,DE,DE,__,__,__
__,__,__,__,DE,SE,BO,__,__,__
__,__,__,__,DE,DE,DE,__,__,__
