__,__,__,DE,__,__,__,__,__,__
BO,DE,DE,DE,__,__,__,__,__,__
SE,DE,__,DE,SP,__,__,__,__,__
__,__,DE,DE,DE,__,__,__,__,__
__,__,SE,DE,__,__,__,__,__,__
__,__,SH,DE,TR,__,__,__,__,__
